{
map: {
	width: 16
	height: 16
	tiles: [
		[ -1, -1, -1, -1, -1, -1, -1, -1, -1, -1, -1, -1, -1, -1, -1, -1 ]
		[ -1, -1, -1, -1, -1, -1, -1, -1, -1, -1, -1, -1, -1, -1, -1, -1 ]
		[ -1, -1, -1, -1, -1, -1, -1, -1, -1, -1, -1, -1, -1, -1, -1, -1 ]
		[ -1, -1, -1, -1, -1, -1, -1, -1, -1, -1, -1, -1, -1, -1, -1, -1 ]
		[ -1, -1, -1, -1, -1, -1, -1, -1, -1, -1, -1, -1, -1, -1, -1, -1 ]
		[ -1, -1, -1, -1, -1, -1, -1, -1, -1, -1, -1, -1, -1, -1, -1, -1 ]
		[ -1, -1, -1, -1, -1, -1, -1, -1, -1, -1, -1, -1, -1, -1, -1, -1 ]
		[ -1, -1, -1, -1, -1, -1, -1, -1, -1, -1, -1, -1, -1, -1, -1, -1 ]
		[ -1, -1, -1, -1, -1, -1, -1, -1, -1, -1, 1, 1, 1, -1, -1, -1 ]
		[ -1, -1, -1, -1, -1, -1, -1, 1, 1, 1, -1, -1, -1, -1, -1, -1 ]
		[ -1, -1, -1, -1, 1, 1, 1, -1, -1, -1, -1, -1, -1, -1, -1, -1 ]
		[ -1, -1, 1, 1, -1, -1, -1, -1, -1, -1, -1, -1, -1, -1, -1, -1 ]
		[ -1, -1, 1, 1, -1, 2, -1, -1, -1, -1, -1, -1, -1, -1, -1, -1 ]
		[ -1, -1, 1, 1, 3, 4, 5, -1, -1, -1, -1, -1, -1, -1, -1, -1 ]
		[ 1, 1, 1, 1, 1, 1, 1, 1, 1, 1, 1, 1, 1, 1, 1, 1 ]
		[ 1, 1, 1, 1, 1, 1, 1, 1, 1, 1, 1, 1, 1, 1, 1, 1 ]
	]
	objects: {
		class: java.util.HashMap
		start: {
			row: 2
			col: 0
		}
		end: {
			row: 3
			col: 5
		}
	}
}
tileset: {
	image: Castle2.png
	tileWidth: 32
	tileHeight: 32
	tilesMap: {
		class: java.util.HashMap
		1: {
			row: 4
			col: 0
		}
		2: {
			row: 14
			col: 9
		}
		3: {
			row: 13
			col: 9
		}
		4: {
			row: 14
			col: 6
		}
		5: {
			row: 13
			col: 10
		}
	}
}
}